   #####
##OO ##
#  B  #
##BB ##
#  B P#
##OO ##
 #####